0
1
processing
0,0,1,1,1,1,0,0,0
1,1,1,0,20,1,1,1,1
1,0,0,10,0,1,0,0,1
1,0,10,0,10,0,0,0,1
1,1,0,0,1,1,0,0,1
0,1,0,2,2,2,0,1,1
0,1,1,1,1,1,1,1,0
