0
4
processing
1,1,1,1,1,1,0,0
1,0,0,0,0,1,1,1
1,0,0,0,2,2,0,1
1,0,10,10,10,20,0,1
1,0,0,1,0,2,0,1
1,1,1,1,1,1,1,1
