0
0
new
0,0,0,0,1,1,1,1
1,1,1,1,1,0,0,1
1,0,0,0,10,0,0,1
1,0,10,10,1,22,2,1
1,0,0,0,0,2,1,1
1,1,1,1,1,1,1,0
