0
0
new
1,1,1,1,1,0,0
1,0,0,0,1,0,0
1,0,0,0,1,1,1
1,0,10,10,12,0,1
1,1,0,0,2,0,1
0,1,1,20,2,0,1
0,0,1,1,1,1,1
