0
0
new
1,1,1,1,1,1
1,20,0,0,0,1
1,0,0,10,2,1
1,0,2,10,0,1
1,1,1,1,1,1
