3
11
processing
0,0,0,0,1,1,1,1
1,1,1,1,1,0,0,1
1,0,0,0,10,0,0,1
1,0,10,10,1,2,2,1
1,0,0,0,0,22,1,1
1,1,1,1,1,1,1,0
