0
2
processing
1,1,1,1,1,1,1,1
1,1,0,0,0,0,1,1
1,20,2,1,1,10,1,1
1,0,2,0,0,10,0,1
1,0,10,0,0,2,0,1
1,1,10,1,1,2,0,1
1,1,0,0,0,0,1,1
1,1,1,1,1,1,1,1
