0
0
new
1,1,1,1,1,1,1,1
1,0,2,0,0,10,0,1
1,2,10,0,0,10,2,1
1,0,10,0,2,20,0,1
1,1,1,1,1,1,1,1
