0
0
new
0,1,1,1,1,1,1
0,1,0,0,0,0,1
1,1,0,1,0,0,1
1,0,2,2,2,0,1
1,0,10,10,10,1,1
1,1,1,20,0,1,0
0,0,1,1,1,1,0
