11
40
processing
1,1,1,1,1,1,0
1,0,0,0,20,1,1
1,0,0,0,10,0,1
1,0,1,12,0,2,1
1,0,0,0,0,0,1
1,1,1,1,1,1,1
