0
8
processing
1,1,1,808080,1,1
1,20,0,0,0,1
1,0,0,10,2121
1,0,2,10,0,1
1,1,1,1,1,1
