0
0
new
1,1,1,1,1,1,1,1
1,1,0,10,0,0,2,1
1,20,0,1,1,10,2,1
1,0,10,0,10,0,2,1
1,0,0,1,0,0,2,1
1,1,1,1,1,1,1,1
