0
0
new
0,1,1,1,1,1,1,0
0,1,0,0,0,0,1,0
0,1,0,0,2,2,1,0
1,1,1,0,1,10,1,1
1,0,0,0,10,0,0,1
1,0,0,20,0,0,0,1
1,1,1,1,1,1,1,1
