0
1
processing
0,1,1,1,1,1,0
1,1,0,0,0,1,1
1,0,0,1,0,1,1
1,0,0,12,10,0,1
1,20,10,2,0,0,1
1,1,0,2,0,1,1
0,1,1,1,1,1,0
